"a" = (/turf/simulated/wall/iron,/area/f13/wasteland)
"b" = (/turf/simulated/floor/grass,/area/f13/wasteland)
"e" = (/turf/simulated/planet_edge,/area/f13/wasteland)
"f" = (/turf/simulated/mineral/random/high_chance,/area/f13/underground/cave)
"n" = (/turf/simulated/floor/exoplanet/desert,/area/f13/building/village)
"o" = (/turf/simulated/wall/r_wall,/area/f13/building)
"p" = (/turf/simulated/floor/exoplanet/desert,/area/f13/builidng/city)
"t" = (/obj/spawner/armor_parts,/turf/simulated/floor/exoplanet/desert,/area/f13/wasteland)
"y" = (/turf/simulated/floor/road{icon_state = "horizontaltopbordertop0"},/area/f13/wasteland)
"z" = (/turf/simulated/floor/exoplanet/desert,/area/f13/building)
"A" = (/turf/simulated/floor/exoplanet/desert,/area/f13/wasteland/forest)
"B" = (/turf/simulated/floor/road{icon_state = "innermiddle"},/area/f13/wasteland)
"C" = (/obj/landmark/join/start/wastelander,/turf/simulated/floor/exoplanet/desert,/area/f13/wasteland)
"D" = (/turf/simulated/floor/exoplanet/desert,/area/f13/wasteland)
"F" = (/turf/space,/area/space)
"H" = (/turf/simulated/floor/exoplanet/desert,/area/f13/wasteland/ruins)
"I" = (/turf/simulated/floor/exoplanet/desert,/area/f13/ncr)
"J" = (/turf/simulated/floor/exoplanet/desert,/area/f13/tunnel)
"K" = (/obj/spawner/ammo,/turf/simulated/floor/exoplanet/desert,/area/f13/wasteland)
"L" = (/obj/vehicle/train/cargo/engine,/turf/simulated/floor/exoplanet/desert,/area/f13/wasteland)
"M" = (/turf/simulated/wall/sandstone,/area/f13/building)
"N" = (/turf/simulated/floor/wood,/area/f13/building)
"O" = (/turf/simulated/floor/tiled,/area/f13/building)
"P" = (/turf/simulated/floor/exoplanet/desert,/area/f13/sewer)
"Q" = (/turf/simulated/floor/exoplanet/desert,/area/f13/underground/cave)
"S" = (/turf/simulated/floor/exoplanet/water/shallow,/area/f13/wasteland)
"T" = (/obj/vehicle/train/cargo/trolley,/turf/simulated/floor/exoplanet/desert,/area/f13/wasteland)
"U" = (/turf/simulated/floor/exoplanet/desert,/area/f13/legion)
"V" = (/turf/simulated/floor/exoplanet/desert,/area/f13/subway)
"Z" = (/turf/simulated/floor/exoplanet/desert,/area/f13/wasteland/radiation)

(1,1,1) = {"
aaaaaaaaaaaaaaaaaaaaaaaaaaaaaaaaaaaaaaaa
eDZZZZZDAAAAADHHHHHHDDQffffffffffffffffe
eDZZZZZDAAAAADHHHHHHDDDQfffffffffffffffe
eDZZZZZDAAAAADHHHHHHDDDQfffffffffffffffe
eDZZZZZDAAAAADHHHHHHDDDDQffffffffffffffe
eDDDDDDDDDDDDDDDDDDDDDDDDQffffffffffffQe
eDDDDDDDDDDDDDDDDDDDDDDDDDQffffffffffQDe
eDDDDDDDDDDDDDDDDDDDDDDDDDDQQfffffffQDDe
eDDDDDDDDDDDDDDDDDDDDDDDDDDDDQQfffQQDDDe
eDDDDDDDDDDDDDDDMMMMMMDDDDDDDQfffffQDDDe
eDDDDDDDDDSDDDDDMNNNNoooDpppDQffffffQDDe
eDDDbDDDDSSSDDDDMNNNNOOoDpppDDQffffQDDDe
eDDDbbDDDSSSSDDDzNNNNOOoDpppDDDQQQQDDDDe
eDDbbbDDDSSSSDDDMNNNNoooDpppDDDDDDDDDDDe
eDDbbbDDDDSSDDDDMMMMMMDDDDDDDDDDDDDDDDDe
eDDDDDDDDDDDDDDDDDDDDDDDDDDDDDDDDDDDDDDe
eDDDDDDDDDDDDDDDDDDDDDDDDDDDDDDDDDDDDDDe
eDDDtDDDDDDDDDDDDDDDDDDDDDDDDDDDDDDDDDDe
eDDDDDDDDDKtCCDDDDDDDDDDDDDDDDDDDDDDDDDe
eDDDDDDDDDDDDDDDDDDDDDDDDDDDDDDDDDDDDDDe
eDDDDDDDDDDDDDTTTLDDDDDDDDDDDDDDDDDDDDDe
eDDDDDDDDDDDDDDDDDDDDDDDDDDDDDDDDDDDDDDe
eDDDDDDDDDDDDDDDDDDDDDDDDDDDDDDDDDDDDDDe
eDDDDDDDDDDDDDDDDDDDDDDDDDDDDDDDDDDDDDDe
eDDDDDDDDDDDDDDDDDDDDDDDDDDDDDDDDDDDDDDe
eDDDDDDDDDDDDDDDDDDDDDDDDDDDDDDDDDDDDDDe
eyyyyyyyyyyyyyyyyyyyyyyyyyyyyyyyyyyyyyye
eBBBBBBBBBBBBBBBBBBBBBBBBBBBBBBBBBBBBBBe
eBBBBBBBBBBBBBBBBBBBBBBBBBBBBBBBBBBBBBBe
eDDDDDDDDDDDDDDDDDDDDDDDDDDDDDDDDDDDDDDe
eDDDDDDDDDDDDDDDDDDDDDDDDDDDDDDDDDDDDDDe
eDDDDDDDDDDDDDDDDDDDDDDDDDDDDDDDDDDDDDDe
eDDDDDDDDDDDDDDDDDDDDDDDDDDDDDDDDDDDDDDe
eDDDDDDDDDDDDDDDDDDDDDDDDDDDDDDDDDDDDDDe
eDDDDDDDDDDDDDDDDDDDDDDDDDDDDDDDDDDDDDDe
ennnnnDJJJJJDIIIIIDUUUUUDPPPPPDVVVVVDDDe
ennnnnDJJJJJDIIIIIDUUUUUDPPPPPDVVVVVDDDe
ennnnnDJJJJJDIIIIIDUUUUUDPPPPPDVVVVVDDDe
ennnnnDJJJJJDIIIIIDUUUUUDPPPPPDVVVVVDDDe
aaaaaaaaaaaaaaaaaaaaaaaaaaaaaaaaaaaaaaaa
"}
(1,1,2) = {"
FFFFFFFFFFFFFFFFFFFFFFFFFFFFFFFFFFFFFFFF
FFFFFFFFFFFFFFFFFFFFFFFFFFFFFFFFFFFFFFFF
FFFFFFFFFFFFFFFFFFFFFFFFFFFFFFFFFFFFFFFF
FFFFFFFFFFFFFFFFFFFFFFFFFFFFFFFFFFFFFFFF
FFFFFFFFFFFFFFFFFFFFFFFFFFFFFFFFFFFFFFFF
FFFFFFFFFFFFFFFFFFFFFFFFFFFFFFFFFFFFFFFF
FFFFFFFFFFFFFFFFFFFFFFFFFFFFFFFFFFFFFFFF
FFFFFFFFFFFFFFFFFFFFFFFFFFFFFFFFFFFFFFFF
FFFFFFFFFFFFFFFFFFFFFFFFFFFFFFFFFFFFFFFF
FFFFFFFFFFFFFFFFFFFFFFFFFFFFFFFFFFFFFFFF
FFFFFFFFFFFFFFFFFFFFFFFFFFFFFFFFFFFFFFFF
FFFFFFFFFFFFFFFFFFFFFFFFFFFFFFFFFFFFFFFF
FFFFFFFFFFFFFFFFFFFFFFFFFFFFFFFFFFFFFFFF
FFFFFFFFFFFFFFFFFFFFFFFFFFFFFFFFFFFFFFFF
FFFFFFFFFFFFFFFFFFFFFFFFFFFFFFFFFFFFFFFF
FFFFFFFFFFFFFFFFFFFFFFFFFFFFFFFFFFFFFFFF
FFFFFFFFFFFFFFFFFFFFFFFFFFFFFFFFFFFFFFFF
FFFFFFFFFFFFFFFFFFFFFFFFFFFFFFFFFFFFFFFF
FFFFFFFFFFFFFFFFFFFFFFFFFFFFFFFFFFFFFFFF
FFFFFFFFFFFFFFFFFFFFFFFFFFFFFFFFFFFFFFFF
FFFFFFFFFFFFFFFFFFFFFFFFFFFFFFFFFFFFFFFF
FFFFFFFFFFFFFFFFFFFFFFFFFFFFFFFFFFFFFFFF
FFFFFFFFFFFFFFFFFFFFFFFFFFFFFFFFFFFFFFFF
FFFFFFFFFFFFFFFFFFFFFFFFFFFFFFFFFFFFFFFF
FFFFFFFFFFFFFFFFFFFFFFFFFFFFFFFFFFFFFFFF
FFFFFFFFFFFFFFFFFFFFFFFFFFFFFFFFFFFFFFFF
FFFFFFFFFFFFFFFFFFFFFFFFFFFFFFFFFFFFFFFF
FFFFFFFFFFFFFFFFFFFFFFFFFFFFFFFFFFFFFFFF
FFFFFFFFFFFFFFFFFFFFFFFFFFFFFFFFFFFFFFFF
FFFFFFFFFFFFFFFFFFFFFFFFFFFFFFFFFFFFFFFF
FFFFFFFFFFFFFFFFFFFFFFFFFFFFFFFFFFFFFFFF
FFFFFFFFFFFFFFFFFFFFFFFFFFFFFFFFFFFFFFFF
FFFFFFFFFFFFFFFFFFFFFFFFFFFFFFFFFFFFFFFF
FFFFFFFFFFFFFFFFFFFFFFFFFFFFFFFFFFFFFFFF
FFFFFFFFFFFFFFFFFFFFFFFFFFFFFFFFFFFFFFFF
FFFFFFFFFFFFFFFFFFFFFFFFFFFFFFFFFFFFFFFF
FFFFFFFFFFFFFFFFFFFFFFFFFFFFFFFFFFFFFFFF
FFFFFFFFFFFFFFFFFFFFFFFFFFFFFFFFFFFFFFFF
FFFFFFFFFFFFFFFFFFFFFFFFFFFFFFFFFFFFFFFF
FFFFFFFFFFFFFFFFFFFFFFFFFFFFFFFFFFFFFFFF
"}
